absently - in an absent-minded manner; inattentively.
ordinary - of no special quality or interest; commonplace; unexceptional:
worldly - of or relating to this world as contrasted with heaven, spiritual life, etc.; earthly; mundane.
everyday - such as is met with every day; ordinary; commonplace:
earthly - of or relating to the earth, especially as opposed to heaven; worldly
commonplace - ordinary; undistinguished or uninteresting; without individuality
prosaic - commonplace or dull; matter-of-fact or unimaginative
routine - a customary or regular course of procedure
terrestrial - of or relating to the earth or this world; worldly; mundane.
temporal - enduring for a time only; temporary; transitory (opposed to eternal )
dull - causing boredom; tedious; uninteresting
secular - a layperson
humdrum - lacking variety; boring; dull:
boring - causing or marked by boredom
terrene - earthly; worldly.
common - of mediocre or inferior quality; mean; low:
normal - conforming to the standard or the common type; usual; not abnormal; regular; natural.
workaday - ordinary; commonplace; everyday; prosaic.
insipid - without distinctive, interesting, or stimulating qualities; vapid:
banal - devoid of freshness or originality; hackneyed; trite:
mediocre - of only ordinary or moderate quality; neither good nor bad; barely adequate:
material - a person considered as having qualities suited to a particular sphere of activity
materialistic - excessively concerned with physical comforts or the acquisition of wealth and material possessions, rather than with spiritual, intellectual, or cultural values.
tedious - wordy so as to cause weariness or boredom, as a speaker, a writer, or the work they produce; prolix.
monotonous - lacking in variety; tediously unvarying:
usual - commonplace; everyday
customary - according to or depending on custom; usual; habitual.
tiresome - causing or liable to cause a person to tire; wearisome:
quotidian - ordinary; commonplace:
pedestrian - lacking in vitality, imagination, distinction, etc.; commonplace; prosaic or dull:
conventional - ordinary rather than different or original:
matter-of-fact - adhering strictly to fact; not imaginative; prosaic; dry; commonplace:
wearisome - tiresome or tedious:
jejune - without interest or significance; dull; insipid:
familiar - commonly or generally known or seen:
dreary - dull; boring.
hackneyed - made commonplace or trite; stale; banal: